date, EH, CH, WH, LG, total, days.since
2021-12-15, 3,1,9,0,13,2
2021-12-17, 11,4,31,0,46,2
2021-12-18, 5,16,2,0,23,1
2021-12-19, 13,16,8,1,38,1
2021-12-20, 4,10,13,0,27,1
2021-12-21, 9,10,8,0,27,1
2021-12-22, 37,10,12,1,60,1
2021-12-23, 73,19,7,1,100,1
2021-12-24, 47,8,26,4,85,1
2021-12-27, 262,29,62,4,357,3
2021-12-28, 154,15,12,13,194,1
